11111111111111111111111111111111111111
1C000000000000000000000000000000000001
10000111000000000000000000000000000001
100001E1000000000000000000000000000001
10000111000000000000000000000000000001
1000000000000000000000000000000C000001
10000000000000000000000000000000000001
10000000000000000000000000000000000001
10000000000000000000000000000000000001
10000000000000000000000000000000000001
10000000C00000000000000000000000000001
10000000000000000000000000000000000001
1000000000000000000000000000P000000001
10000000000000000000000000000000000001
10000000000000000000000000000000000001
1000000000000C000000000000000000000001
10000000000000000000000000000000000001
11111111111111111111111111111111111111