11111111111111111111111111111111111111
1000000000000C000000000000000000000001
100000P0000000000000000000000000000001
1000000000000000000000000X000000000001
10C000000000000000000C0000000000000001
10000000000C00000000000000000000000001
100E0000000000000000000000000000000001
10000000000000000000000000000000000001
10000000X00000000000000000000000000001
10000000000000000000000000X00000000001
100000000000C0000000000000000000000001
10000000000000000000000000000000000001
10000000000000000000000000000000000001
1000000X00000000000000000C000000000001
10000000000000000000000000000000000001
100000000C0000000X00000000000000000001
10000000000000000000000000000000000001
11111111111111111111111111111111111111