111111111111111
1000000000000C1
100000P00000001
100000000000X01
10C000000000001
10000000000C001
100E00000X00001
111111111111111