11111111111111
1C000000000001
10000XXX000001
10000XEX000001
10000XXX000001
1000C00000P001
10000000000001
11111111111111