11111111111111
1C100000000001
11100000000001
100000E0000001
10000000000001
1000C00000P001
10000000000001
11111111111111