11111111111111
1C000000000001
10000111000001
100001E1000001
10000111000001
1000C00000P001
10000000000001
11111111111111