111111111111111
1E00001000000C1
111110100000001
100000100000001
100000000011101
10110000001C001
101C0000P010001
111111111111111