111111111111111111
1C0000000000000001
100000P000000000C1
100000000000001011
100000000000001C11
10000C00000C001011
100000000000001011
1C00000000000000E1
111111111111111111
