111111111111111111111111111
1000000000000C0000000000001
100000P000000000000000X0001
100000000000X00000000000001
10C000000000000000000C00001
10000000000C000000000000001
100E00000X00000000000000001
100000000000000000000X00001
10000000000000000X000000001
10000000X000000000000000001
111111111111111111111111111