111111111111111111111111111111111111111
1000000000000C0000000000000000000000001
100000P00000000000000000000000000000001
100000000000000000000000000000000000001
10C000000000000000000C00000000000000001
10000000000C000000000000000000000000001
100E00000000000000000000000000000000001
100000000000000000000000000000000000001
100000000000000000000000000000000000001
100000000000000000000000000000000000001
100000000000C00000000000000000000000001
100000000000000000000000000000000000001
100000000000000000000000000000000000001
1000000000000000000000000C0000000000001
100000000000000000000000000000000000001
100000000C00000000000000000000000000001
100000000000000000000000000000000000001
100000000000000000000000000000000000001
111111111111111111111111111111111111111