111111111111111111
111111111111111111
1111P1111111111111
111101111111111111
111100C00111111111
111111110111111111
11111111E111111111
111111111111111111
111111111111111111
111111111111111111