111111111111111111111
1CCCCCCCCCCCCCCCCCCC1
1ECCCCCCCCCCCCCCCCCC1
1CCCCPCCCCCCCCCCCCCC1
1CCCCCCCCCCCCCCCCCCC1
1CCCCCCCCCCCCCCCCCCC1
1CCCCCCCCCCCCCCCCCCC1
1CCCCCCCCCCCCCCCCCCC1
1CCCCCCCCCCCCCCCCCCC1
111111111111111111111