111111111111111
1000000000000E1
100000P00000001
100000000000001
10C000000000001
10000000000C001
100E00000000001
111111111111111