111111111111111
100000000000001
100000P00000001
100000000C00001
100000000000001
1000C0000000001
100000000000001
111111111111111