111111111111111
100C00000000001
100000000000001
100000000000001
10000000000C001
100000000000001
100E00000000001
111111111111111